010,010,010,010,010,010,010,010,010,010,010,010,010,010,010,010,010,010,010,010,010,010,010,010,010
010,100,030,030,030,030,030,030,030,030,030,030,030,030,030,030,030,101,010,110,121,121,121,111,010
010,033,020,020,020,020,020,020,020,020,020,020,020,020,020,020,020,031,010,120,130,130,130,122,010
010,033,020,020,020,020,020,020,020,020,020,020,020,020,020,020,020,031,010,120,130,130,130,122,010
010,033,020,020,020,020,020,020,020,020,020,020,020,020,020,020,020,031,010,120,130,130,130,122,010
010,033,020,020,020,020,020,020,020,020,020,020,020,020,020,020,020,031,010,113,123,123,123,112,010
010,033,020,020,020,020,020,020,020,020,020,020,020,020,020,020,020,031,010,110,121,121,121,111,010
010,033,020,020,020,020,020,020,020,020,020,020,020,020,020,020,020,031,010,120,130,130,130,122,010
010,033,020,020,020,020,020,020,020,020,020,020,020,020,020,020,020,031,010,120,130,130,130,122,010
010,033,020,020,020,020,020,020,020,020,020,020,020,020,020,020,020,031,010,120,130,130,130,122,010
010,033,020,020,020,020,020,020,020,020,020,020,020,020,020,020,020,031,010,120,130,130,130,122,010
010,033,020,020,020,020,020,020,020,020,020,020,020,020,020,020,020,031,010,120,130,130,130,122,010
010,033,020,020,020,020,020,020,020,020,020,020,020,020,020,020,020,031,010,120,130,130,130,122,010
010,033,020,020,020,020,020,020,020,020,020,020,020,020,020,020,020,031,010,120,130,130,130,122,010
010,033,020,020,020,020,020,020,020,020,020,020,020,020,020,020,020,031,010,120,130,130,130,122,010
010,033,020,020,020,020,020,020,020,020,020,020,020,020,020,020,020,031,010,120,130,130,130,122,010
010,033,020,020,020,020,020,020,020,020,020,020,020,020,020,020,020,031,010,120,130,130,130,122,010
010,033,020,020,020,020,020,020,020,020,020,020,020,020,020,020,020,031,010,120,130,130,130,122,010
010,103,032,032,032,032,032,032,032,032,032,032,032,032,032,032,032,102,010,113,123,123,123,112,010
010,010,010,010,010,010,010,010,010,010,010,010,010,010,010,010,010,010,010,010,010,010,010,010,010
